***************
*         *****
****** ****   *
*      **** * *
* **** *    * *
*    * **** * *
******      * *
************* *
*      **     *
* * ***** *****
* * **        *
* *    ****** *
* *************
*             *
***************